########################################
#                #                     #
#                #                     #
#                                      #
#                #                  ####
#                #                  #  #
#                                   #  #
#                #                  #  #
#                #                  #  #
#                                   #  #
#                #                ###  #
#                #                     #
########################################